a matter of speculation 	n. 推断	supposition
a solicitation of 	n. 垦求;垦请	an invitation of
abandoned	a. 被遗弃的	left
aberrant	a. 脱离常轨的,	abnormal
abort	v. 夭折;中止	quit
abrupt	adj.突然的	sudden
abruptly	ad. 突然地;意外地	suddenly
absorb 	v. 吸收;被…吸引	appeal
absorb	v. 吸收;被…吸引	take in
abstract	a. 抽象的;非实际的	not concrete
absurd	a. 荒谬的;可笑的	ridiculous
abundance	n. 大量	great number
abundance	n. 大量	large amount
abundant 	a. 丰富的;大量的	affluent
abundant	a. 丰富的;大量的	ample
abundant	a. 丰富的;大量的	numerous
abundant	a. 丰富的;大量的	plentiful
abundant	a. 丰富的;大量的	substantial
abundant	adj.丰富的	ample
abundantly	ad. 丰富地;大量地	plentifully
access 	v. 接近	reach
accessible 	a. 易接近的	easy to reach
accessible 	a. 可接近的	reachable
accidental 	a. 意外的;偶然的	unexpected
accommodate	v. 提供	provide for
accomplished 	a. 实现完成的	achieved
accomplished 	a. 熟练的	skilled
account for	v. 说明	explain
account	n. 说明	description
accumulate 	v. 积累;聚集	collect
accumulate 	v. 积累;聚集聚集	pile up
accumulate	v. 积累	build up
accurate 	a. 正确的	correct
accurately	ad. 正确地	correctly
acknowledge	v. 承认	recognize
actually	ad. 事实上	in fact
added 	a. 附加的;额外的	extra
adept 	a. 熟练的	skilled
adherent	n. 拥护者	supporter
adherent	n.追随者，提倡者	advocate
adjacent 	a. 毗连的	nearby
adjacent 	a. 毗连的	neighboring
adjust	v. 调整;改变…以适应	modify
administer 	v. 管理	manage
admit	v. 准许进入	let in
adopt	v. 采用	enact
advance	n. 发展;增长	improvement
advent	n. 出现;到来	arrival
advent	n. 出现;到来	beginning
affair	n. 事件;事情	matter
afford	v. 提供;给予	provide
aggravate 	v. 使恼火	annoy
aggravate	v. 加重;增剧	increase
aggregate	a. 聚集的;合计的	combined
aggregate	a. 聚集的;合计的	overall
aggregation	n.聚合，聚集；聚集体，集合体	group
agile	a. 灵活的;敏捷的	astute
agile	a. 灵活的;敏捷的	clever
agile	a. 灵活的;敏捷的	move and act quickly
agile	a. 灵活的;敏捷的	quick and active
air	n. 气氛	feeling
alarm	v. 警报	sound
alarm	n. 警告	warning
albeit 	conj. 尽管；虽然	even though
albeit	conj. 尽管；虽然	although
allow	v. 允许	enable
allude to	phrv. 提到	refer to
allude	v. 暗示	suggest
ally with	v. 结盟	link to
alter	v. 改变	change to
amazing	a. 令人惊讶的/非凡的	remarkable
ambiguous 	a. 不明确的	vague
ambivalent 	a. 矛盾的	mixed
ample 	a. 宽敞的	spacious
ample	a. 充足的;丰富的	plentiful
anchor	v. 使固定	hold in place
ancient 	a. 古老的	antique
ancient	a. 古老的	old
annihilate 	v. 消灭	completely remove
annihilate	v. 消灭	destroy
annihilated	v.废止	destroy
annually	ad. 每年	yearly
anomaly	n. 异常的人或物	irregularity
antagonist 	n. 对手;敌手	competitor
anticipate	v. 预期	expect
antiseptic 	a. 抗菌的	clean
antithesis	n. 对立面	opposite
antler 	n. 鹿角	horn
anxiety 	n. 忧虑;担心	worry
apart from 	phr. 除了…之外	except for
apart from	phr. 除了…之外	exception
apparatus	n. 仪器;设备	equipment
apparent 	a. 显然的	obvious
apparently	ad. 显然地	clearly
apparently	adv. 显然地； 似乎	seemingly
bustling	adj. 忙乱的	busy
appeal	n. 吸引力	attraction
appealing 	a. 有吸引力的	attractive
appear	v. 似乎	seem
appearance	n. 出现	arrival
appearance	n. 出现	rise
appearance	n. 出现	showing up
application	n. 应用	use
appreciable	a. 相当可观的	noticeable
approach 	n. 方法	method
approach	v. 接近	move toward
approximately	ad. 大约地	roughly
architecture	n. 构造	structure
archive	v. 存档	record
archive	v. 存档	stock
archive	v. 存档	store
arduous	a. 艰巨的	difficult
arid 	a. 干旱的	dry
arid	adj.干旱的	dry
arise	v. 出现	emerge
arrangement	n. 安排;布置	configuration
array	n. 一系列	range
article	n. 物品	item
article	n. 物品	object
as a rule 	phr. 通常	in general
assert	v. 断言;宣称	declare
assertion	n. 断言;主张	strong statement
asset	n. 资产;有利条件	advantage
assimilate	v. 同化	combine
assistance	n. 帮助；协助	help
assorted	a. 各式各样的	various
assume	v. 假定;设想	believe
assume	v. 假定;设想	suppose
assume	v. 承担	take on
assumption	n. 假设	premise
astonishing	a. 惊人的	amazing
astoundingly	adv.使人震惊的	incredibly
astute	a. 敏锐的	clever
at random	phr. 随便地;任意地	without a definite pattern
attachment to	n. 依恋	preference for
attain 	v. 达到;获得	achieve
attainment 	n. 达到;获得	achievement
attendant	a. 伴随的	accompanying
attest to 	v. 证实	confirm
attribute 	n. 特点	characteristic
attribute to 	v. 归于; 认为	credit with
attribute	v. 归于;认为	accredit
attribution 	n. 属性	character
augment	v. 增加;提高	increase
available 	a. 可获得的	obtainable
avenue 	n. 途径;手段	means
avenue	n. 途径;手段	method
avid	a. 热衷的	enthusiastic
barely 	ad. 仅仅	just
barge	n. 驳船	boat
barrier 	n. 障碍	impediment
barrier	n. 障碍	obstacle
battle	n. 搏斗;奋斗	struggle
be accustomed to	phrv. 习惯	get used to
be aware of 	phrv. 了解	familiar with
be beforehand	v. 预先	foreordain
be closer resemblance to	phr. 非常相似	be more like
be consistent with	phr. 一致的	be compatible with
be entitled to	phrv. 有…权利	have the right
be inclined 	v. 倾向	tend
beckon	v. 招唤;引诱	invite
become extinct	phrv. 灭绝	die out
being	n. 生命	creature
beneficial 	a. 有益的	advantageous
blossom	v. 兴旺	flourish
blossom	v. 兴旺	thrive
boast	v. 吹嘘	exaggerate
boast	v. 吹嘘	puff
bombard 	v. 炮击;轰击	assault
bombard 	v. 炮击;轰击	strike
bombard	v. 炮击;轰击	assail
boom	n. 激增;爆涨	expansion
boon	n. 利益	great benefit
boost	v. 增加;提高	raise
boundary	n. 边界	periphery
branch 	n. 分支	division
breakthrough	n.突破，革命	revolution
breed	v. 繁殖;饲养	reproduce
brew	vt.开发	develop
brilliant	a. 光辉的;明亮的	bright
brittle	a. 脆弱的	breakable
brittle	a. 脆弱的	fragile
broad appeal 	a. 广泛的吸引力	wide popularity
broadly 	ad. 大体上	generally
broadly	ad. 大体上	extensively
bulk 	n. 主体	major part
bulk	n. 大部份	great quantity
bulk	n. 大部份	large part
bulk	n. 大部份	large portion
bulk	n. 大部份	majority
burgeon	v. 急速成长	expand
bustling	a. 活跃的	lively
camouflage 	v. 伪装	hide
camouflage	v. 伪装	blend with circumstances
camouflage	v. 伪装	disguise
cardinal	a. 基本的	fundamental
cargo	n. 船货;货物	shipment
catastrophic	a. 灾难性的	badly harmful
celebrated	a. 着名的	famous
central	a. 主要的	essential
certain	a. 指定的	specified
champion	vt.提升，提拔	promote
chancy 	a. 冒险的	risky
channel 	v. 引导	direct
channel 	v. 引导	guide
channel 	v. 提供帮助	provide
chaotic	a. 混乱的	disorganized
cherish 	v. 珍爱	value
chief	a. 主要的	major
chisel 	v. 刻;凿	carve
choose	v. 选择	opt
chronic 	a. 长期的;不断的	confirmed
chronic 	a. 长期的;不断的	inveterate
chronic	a. 长期的;不断的	habitual
chronic	a. 长期的;不断的	persistent
chronically	ad. 长期地	constantly
circuitous 	a. 迂迴的	indirect
circumstance	n. 环境;情况	condition
circumstance	n.情况	situation
cite 	v. 引用	refer to
cite	v. 引用	quote
classic 	a. 典型的	typical
clear 	a. 容易看见的	visible
clear	a. 显然的	apparent
cling to	v. 附着	attach to
close	a. 严密的;周密的	careful
clue	n. 线索	hint
clung to	v.坚持	hold
cluster	n.组，群	group
coating	n. 覆盖层	cover
coincide with	v. 同时发生	be as the same time as
collaborate	v. 合作	cooperate
collaboration	n. 合作成果	joint effect
collect 	v. 收集	gather
collide with 	v. 碰撞	run into
collide	v. 碰撞	hit each other
colossal	adj.巨大的	enormous
commemorate 	v. 庆祝;纪念	celebrate
commonly	adv.通常地	generally/normally
compact 	a. 紧密的;简明的	concise
comparable	a. 可比较的	equivalent
comparative 	a. 相当的	relative
compel 	v. 强迫	push
compelling	a. 令人信服的	convincing
compelling	adj.强烈的，引人入胜的	forcing
compensate for 	phrv. 赔偿;补偿	balance
compensate	v. 赔偿;补偿	reimburse
complaint 	v. 抗议	protest
complement	v. 补充	add to
complement	n. 补充物	supplement
completely	ad. 完全地	totally
complex 	n. 复合物;综合体	system
complex	a. 复杂的	elaborate
complicated 	a. 复杂的	complex
complicated 	a. 复杂的	made things more difficult
component	a. 组成的	constituent
composition	n. 合成物	mixture
comprehensive	a. 全部的	complete
comprehensive	a. 能理解的	understandable
comprehensive	adj.全面的，彻底的	thorough
comprise 	v. 组成	make up
comprise	v. 组成	form
compulsory	adj.必须的	required
consensus	n.一致	agreement
concern	v. 感兴趣	interest
conclusive	a. 最后的	final
conclusive	a. 最后的	ultimate
conducive	a. 有助于...的	contributive
configuration	n. 布局;结构	arrangement
configuration	n. 佈局;结构	form
confine 	v. 限制	limit/boundary
confined	adj.有限的	limited
confined	v. 限制	restricted
confront	v. 面临	face
congeal	v. 使凝结	solidify
congregate	vt. vi（使）集合，聚集	gather
consecutive	a. 连续的	successive
consequence 	n. 结果;重要性	importance
consequence	n. 结果;重要性	result
consequent 	a. 作为结果的	resulting
consequent	a. 随后的	later
consequent	a. 作为结果的	resultant
consequential	a. 重要的	significant
consequently	ad. 因此	therefore
consequently	ad. 因此	thus
conserve	v. 保存	save
consider 	v. 考虑;认为认为	think about
consider 	v. 考虑;认为	think as
consider 	v. 考虑;认为	view as
considerable	a. 相当大的	substantial/significant
considerably	adv.相当大地	greatly
consist of 	v. 由…组成	compose of
consistent	a. 一致的	regular
consistently	ad. 一致地	regularly
conspicuous	a. 明显的	notable
constant 	a. 固定的;不变的	stable
constantly 	ad. 经常;不断地	always
constellation 	n. 一系列;一群	collection
constellation 	n. 一系列;一群	combination
constitute	vt. 组成，构成；建立	make up
constitution	n. 构造	component
constrain 	v. 限制	restrict
constraint	n. 限制	limit
constraint	n. 限制	restriction
consume	v. 消耗;吃;喝吃;喝	eat up
consume	v.耗尽	use completely
consumed	v. 消耗	used up
contains	v.包含	includes
contemplate	v. 沉思	consider
contemporary	adj.现代的	modern
contentious	a. 好争吵的	disputed
contiguous	adj.临近的	neighboring
continual	a. 不间断的;连续的	constant
continuous 	a. 连续的;持续的	uninterrupted
continuous	adj.不断前进的	ongoing
contour	vt. 画轮廓	outline
contrive	v. 发明	create
contrive	v. 发明	invent
conventional	a. 习惯的;惯例的	customary
conventional	a. 习惯的;惯例的	traditional
converging	a. 收缩的;会聚的	concentrating
convert 	v. 使转变	transform
convert into	v. 转变成	change to
convict 	v. 宣判	sentence
convict	v. 宣判	condemn
conviction 	n. 坚定的信念	strong belief
conviction	n. 相信;信念	belief
convince	vt.劝说，说服	persuade
cope with	phrv. 应付;处理	deal with
cope with	phrv. 应付;处理	handle
copious	a. 丰富的;大量的	plentiful
core 	n. 核心;要点	center
correlate	v.相关，关联	match
correspondence	n. 一致	harmony
corroborate	v. 证实;确证	confirm
costly	a. 贵重的;昂贵的	expensive
counsel 	v. 忠告	advise
counter of	a. 相反的	in the opposite of
counter	v. 反对	oppose
counterpart	n. 复本;副本	equivalent
counterpart	n. 复本;副本	similitude
counterpart	n. 复本;副本	version
countervail 	v. 抵销;对抗	compensate
countervail	v. 抵销;对抗	oppose
countless	a. 数量很多的	innumerable
couple 	v. 与…联系起来	associate
covered	a. 隐蔽的;有盖的	included
crawl 	v. 爬行;移动	move
create	v. 创作;产生	invent
creative	a. 创造的	inventive
crest	n. 顶峰	peak
critical 	a. 关键的	crucial
critical	a. 关键的	essential
criticize 	v. 批评;责备	debate
crucial	a. 重要的	important
crucially	ad. 关键地	decisively
crushed 	a. 碾碎了的	ground
cumbersome	a. 笨重的;麻烦的	awkward
cumbersome	a. 笨重的;麻烦的	clumsy
cumbersome	a. 笨重的;麻烦的	unwieldy
curb	v. 控制;遏止	control
current 	a. 现在的	present
cushioned	a. 保护	protected
dam	v. 筑坝;控制	block
dangle	v. 悬摆;吊	hang
daring 	a. 大胆的	bold
debate	v. 辩论;争论	argue
decimate	v. 大量毁灭	destroy
decimation	n. 大量毁灭	destruction
deficient	a.不足的	inadequate
degree 	n. 程度	extent
degree	n. 程度	measure
delicate	a. 易碎的;精美的	dainty
delight	v. 使高兴	please
delight	n. 高兴;愉快	pleasure
deluxe	a. 奢华的	lavish
demand	n. 需要;需求	need
demise 	n. 死亡	extinction
demography	n. 人口统计	population
dense	a. 稠密的;密集的	crowded
dense	a. 稠密的;密集的	thick
depend	v. 依赖;依靠依靠	rely on
dependable	a. 可信赖的	reliable
depict	v. 描述	describe
depict	v. 描写;描绘	portray
deplete	vt. 耗尽，用尽	exhaust
depletion	n. 消耗;用尽	drain
deposit 	v. 沉积	accumulate
deposit	v. 放下;放置	lay down
derive	v. 源于;导出	arise
desiccated	adj. 干的	dry
design 	v. 设计	create
designate	v. 命名;指定	identify
detected	vt.认出，识别	identified
determine	vt. 决定；判决	figure out
detractor	n. 诽谤者;恶意批评者	critic
detrimental 	a. 有害的;不利的	harmful
deviate	v. 偏离	digress
deviation	n. 背离	departure
devise	v. 设计;发明	create
devoid of	a. 缺乏的	lack of
devoid of	a. 缺乏的	scant of
devoid of	a. 缺乏的	without
devoted 	a. 虔诚的;专心致志的	dedicated
devoted to 	a. 虔诚的;专心致志的	concentrated on
devour 	vt. 吞食	eat
dictate	v. 口授;命令	determine
dictate	v. 命令	order
differential	a. 差别的;独特的	uneven
diffuse 	v. 扩散;散布	travel
diffuse	v. 扩散;散布	spread
dilemma	n. 困境；进退两难	problem
diligent	a. 勤奋的	careful
diligently	ad. 勤奋地	carefully
dilute	v. 稀释;使薄弱	reduce
dim	v. 变暗淡	decrease
dim	adj.暗淡的，弱的	weak
dimension	n. [数] 维；尺寸；次元	aspect
dimension	n.尺寸	size
disassemble 	v. 拆开	break up
disassemble	v. 拆开	break apart
disband 	v. 解散;遣散	dismiss
discard	v. 摒弃;丢弃	throw away
discard	v. 摒弃;丢弃丢弃	throw up
discernible 	a. 可感知到，可注意到的	noticeable
discernible	a. 可辨别的	discriminating
discernible	a. 可辨别的	noticeable
discharge	v. 释放	release
discrete	adj.分开的	separate
disentangle 	v. 解开	disband
disgust	v. 厌恶	distaste
disintegrate 	v. 分解;碎裂	fall apart
disintegrate	v. 分解;碎裂	break apart
disintegrate	v. 分解;碎裂	tear apart
dismantle 	v. 拆开;拆除	demolish
disorder	n. 混乱	anarchy
dispensable	a. 非必要的	not necessary
dispersal 	n. 散布;驱散	distribution
dispersal	n.传播，散布	spread
displace	v. 迫使(人)离开	move out of position
disposition	n. 性格;性情	temperament
dispute 	n. 争论;争执	argument
dispute	n. 争论;争执	contention
dissipate	v. 驱散	disperse
dissipated 	a. 分散的	dispersed
dissuade 	v. 劝阻	discourage
distant	adj.遥远的	far
distinct	a. 清楚的;明确的	clear and recognizable
distinction	n. 差别	difference
distinction	n. 优秀;卓越	excellence
distinction	n. 荣誉	honor
distinctive	a. 有特色的	characteristic
distinguish	v. 区别; 识别	notice from the difference
distribute	v. 分配;散布	spread
distribution 	n. 分布区域	geographic range
distribution	n. 散布	dispersion
disturb	v. 打乱；扰乱	upset
diverse	a. 不同的	distinct
diverse	adj.不同的	various
diversification	n. 多样化	emergence of many varieties
diversity 	n. 多样性	variety
divest 	v. 剥夺	deprive
divest 	v. 剥夺	get rid of
doctrine	n.原则	principle
domestic	a. 家庭的;国内的	home
dormant	a. 休眠的;不活动的	hibernated
dormant	a. 休眠的;不活动的	inactive
dramatically	ad. 戏剧性地	greatly
drastic	a. 激烈的;极端的	extreme
drastically 	ad. 大大地;彻底地	obviously
drastically 	ad. 大大地;彻底地	severely
dual 	a. 双的;双重的	double
duplicate	v. 复制	copy
duplicate	n. 复本	repeat
durable	a. 经久的;持久的	lasting
earn	v. 赚得;赢得	acquire
ease	v. 使减轻;使缓和	facilitate
eccentric 	a. 古怪的;反常的	strange
eccentric	a. 古怪的;反常的	erratic
efface	v. 消去	eliminate
elaborate 	a. 精巧的;详尽的	detailed
elaborate	a. 精巧的;详尽的	dainty
elapsed 	a. 过去的;经过的	passed
element 	n. （恶劣的）天气	weather condition
elevate	vt.举起，提升	raise
eliminate	v. 排除;消除	remove
elite	n. 精英；精华	excellent person
elusive 	a. 难懂的;难捉摸的	difficult to catch
emanate	v. 散发;产生	emerge
embark on	v. 从事(着手)	start
embed 	v. 插入;植入	enclose
embed	v. 插入;植入	implant
embed	v. 插入;植入	insert
emergence	n. 出现	appearance
emergency 	n. 紧急情况	crisis
emergent 	a. 新兴的	developing
employ	v. 利用	use
enable 	v. 使能够	allow
enactment	n. 制定	establishment
encapsulate	v. 概述	state briefly
encounter	vt. 遭遇，邂逅	meet
encourage	v. 激励；刺激	stimulate
end	n.目的	purpose
endangered	a. 濒临绝种的	not abundant
endeavor	n. 努力	enterprise
endorse	n.认可，支持	support
endow	v. 捐赠	bestow
enduring	adj.耐心的，持久的	withstanding
engulf	v. 吞没	swallow
engulfed	vt.吞咽	swallow
enhance	v. 提高;增强	improve
enhance	v. 提高;增强	intensify
enjoy 	v. 经历	experience
enlist	v. 谋取（支持、赞助等）	obtain
enormous	a. 巨大的	great
enormous	adj.庞大的，巨大的	very large
enrich	v. 使富足	enhance
ensue	v. 因…产生	result
ensuing	a. 接着发生的	subsequent
ensure	v. 保证;担保	guarantee
entail	v. 牵涉	l involve
enthusiastic	a. 热情的	eager
entirely	adv. 完全地，彻底地	wholly
environment	n. 环境	setting
envision	vt. 想像	imagine
ephemeral 	a. 短暂的	short-lived
ephemeral 	a. 短暂的	transient
episode	n. 事件	event
equilibrium	n. 平衡	balance
era 	n. 时代;年代	period
eradicate	v. 根除;消灭	remove completely
erect 	v. 建立	build
erratic	a. 不稳定的;古怪的	irregular
erratic	a. 不稳定的;古怪的	unpredictable
escalate	v. 逐步扩大	extend
essential	a. 极重要的	crucial
essential	adj.必须的	required
essentially	adv.本质上，根本	fundamentally
established 	a. 已制定的	qualified
establishment 	n. 建立;创立	formation
estimate	n. 估计	projection
estimation 	n. 估计	evaluation
euphoric	a. 心情愉快的	extremely happy
evaluate	v. 评价	judge
eventual	a. 最后的	later
eventual	adj.最终的	final
eventually	adv.最后，终于	finally
eventually	ad. 最后	later
eventually	ad. 最后	ultimately
eventually	adv. 最后，终于	in the end
evidence	n. 证据	proof
evident 	a. 明显的	obvious
evident	a. 明显的	apparent
evoke 	v. 唤起; 引起	create in the mind
evoke	v. 唤起;引起	arouse
evoke	v. 唤起;引起	draw
evoke	v. 唤起;引起	promote
evoke	v. 唤起;引起	stimulate
evoke	v. 唤起;引起	produce
evolve	vt. 发展，进化	develop
exaggerate 	v. 夸张;夸大	overstate
excavate 	v. 挖掘	dig out
excavation 	n. 挖掘	dug-out
exceed 	v. 超越;胜过胜过	beyond above
exceed	v. 超越;胜过	surpass
exceedingly 	ad. 极其;非常	extremely
excess 	n. 超越; 胜过	go beyond
exclusively	ad. 专门地;独占地	only
exclusively	adv. 唯一地	solely
excrete	v. 排泄;分泌	expel
exercise 	v. 运用	use
exert	vt. 运用，发挥	utilize
exhausted	a. 精疲力竭的	tired
exhausted	a. 耗尽的;用完的	used up
exhibit 	v. 展示;陈列	demonstrate
exhibit 	v. 展示;陈列	display
expand 	v. 展开;增长	increase
expand	v. 展开;增长	stretch
expanse	n. 一大片区域	area
expansive	a. 广阔的	large
expediency	n. 方便；利己	advantage
expediency	n. 方便;利己	convenience
expedient	a. 权宜的;方便的	fitting
expend	v. 耗尽	use
explicit 	a. 明确的;清楚的	obvious
explicitly	ad. 明确地	clear
exploit	v. 利用	make use of
exploit	v. 利用	take advantage of
exploit	v. 利用	utilize
explore	v. 探测;探索	investigate
expose to	v. 使经历	subject to 
express	v. 表达	communicate
extant 	a. 现存的;尚存的	remaining
extant	a. 现存的;尚存的	existing
extant	a. 现存的;尚存的	not extinct
extend	v. 延伸	reach
extend	v. 延伸	stretch
extensive	adj. 广泛的；大量的；广阔的	broad
extensive	adj.广泛的，大量的	large
extol 	v. 赞美	praise
extraneous	a. 无关的;外来的	from outside
extraneous	a. 无关的;外来的	inessential
extraordinary	a. 异常的	exceptional
exude	v. 渗出;发散	give off
exude	v. 渗出;发散	release
fabricate	v. 制造	produce
facet	n.方面	aspect
fascinating	a. 迷人的	extremely attractive
fashion	v. 形成;造	make
fashion	n. 样子;方式	way
fashionable 	a. 流行的;时尚的	popular
feasible	a. 可实行的	achievable
feasible	a. 可实行的	practical
feasible	adj.可能的	probable
feast	n. 盛宴	eating
ferry	n. 渡轮	transport
fertile	a. 肥沃的;多产的	productive
fertile	a. 肥沃的;多产的	reproductive
figure out 	phr. 计算出;解决	map
finding	n. 发现	discovery
first and foremost 	phr. 首先;首要地	above all
flake 	n. 小薄片	fragment
flattery	n. 恭维	praise
flee	v. 逃走	run away from
flexible	a. 易适应的	adaptable
float 	phrv. 浮起	upward rise
float	v. 漂浮	stay on the top
flourish 	v. 繁荣;兴旺	prosper
flourish	v. 繁荣;兴旺	thrive
flourishing	a. 繁荣的	prosperous
flow	n. 流动	movement
fluctuate	v. 变动	change
fluctuation	n. 变动;起伏	variation
focus 	n. 焦点	point centre area
focus	vt.使集中	concentrate
follow	v. 跟随	track
for instance	phr. 例如	for example
forage 	v. 觅食	search for food
forage	n. 饲料	feed
foremost	adj.重要的	important
formidable 	a. 巨大的	excessive
foster 	v. 培养;促进	promote the development of
foster	v. 鼓励	encourage
foster	v. 培养;促进	urge
foul	v. 污染	pollute
fragment	v. 使成碎片	break up
fragmentation	n. 破裂	break
fragmentize	v. 使成碎片	break up
frankly 	ad. 坦白地	openly
frankly	ad. 真诚地	sincerely
friction	n. 争执;不合	conflict
function	n. 效用;作用	operation
function	n. 效用;作用	utility
fundamental 	a. 基础的	basic
funds	n. 资金	money
furthermore	ad. 此外	in addition
furthermore	adv. 此外；而且	moreover
gap	n. 缺口;裂口	opening
gear 	v. 使适合	adjust
generate	v. 产生	produce
genuine	adj. 真实的，真正的；诚恳的	true
genuinely 	ad. 真诚地	actually
gesture	n.姿势，动过	movement
get accustomed to	phrv. 习惯	become used to
give rise to	phrv. 引起	produce
given 	a. 规定的;特定的	particular
govern	v. 统治;管理	control
govern	v. 统治;管理	regulate
grasp 	v. 领会;理解	understand
groom 	v. 装扮;使整洁使整洁	make up
groom	v. 装扮;使整洁	clean
groundless 	a. 无根据的	unfounded
grounds 	n. 根据;理由	reasons
groundwork	n. 基础	base
groundwork	n. 基础	basis
groundwork	n. 基础	foundation
grudging	a. 勉强的	unenthusiastic
guarantee	v. 保证;担保	ensure
hairline	adj.细小的，纤细的	slight
hallmark	n. 戳记，标志	characteristic
hamper 	v. 防碍;束缚	district
hamper 	v. 防碍;束缚	make difficulty
hamper	v. 防碍;束缚	restrict
handy	a. 便利的;灵活的	convenient
haphazard	a. 随意的	random
harness	v. 利用	use
harness	v. 利用	utilize
harsh	a. 严厉的;严酷的	drastic
hasty	a. 匆匆的;急忙的	hurried
haul	v. 拉	pull
have nothing to do with	phrv. 不相干	in no relation to
havoc	n. 浩劫	destruction
hazard 	n. 危险	danger
heed	v. 留心;注意	notice
heighten	v. 增加;提高	increase
heir	n. 继承人;后继者	inheritor
hence	ad. 因此	therefore
heritage 	n. 遗产;传统	legacy
heritage	n. 遗产;传统	tradition
heterogeneous	a. 由不同种类组成的	varied
hide	v. 隐藏	conceal
hinder	v. 妨碍	interfere with
hint	n. 暗示;迹象	clue
hint	n. 暗示;迹象	implication
hint	n. 暗示;迹象	indication
hint	n. 暗示;迹象	lead
hire	v. 雇用	employ
hitherto	adv.先前的	previously
hobby	n. 嗜好	pastime
hold 	v. 支撑;保持	support
hold	v. 支撑;保持保持	keep up
hollow	n. 中空	an empty space
homogeneous 	a. 同种的	uniform
host of 	n. 大量	great number
however 	conj. 然而	yet
hub	n. 中心	center
huge	a. 巨大的	large
hurdle 	v. 用篱笆围	fence
hypothetical 	a. 假设的;假定的	supposed
ice sheet	n. 冰原	glacier
identical	a. 同样的	the same
idiosyncrasies 	n. 特性	peculiarity
ignite	v. 点燃	set on fire
illuminate	adj.明亮的	bright
illusion	n. 错觉;幻像	impression
immediately	ad. 接近;紧接着	closest
immense	a. 巨大的	great
immense	a. 巨大的	huge
immense	a. 巨大的	vast
immensely	ad. 非常	extremely
immigration	n. 移居	movement
immobile	a. 固定的;静止的	fixed
immobility	n. 固定;静止	absence of motion
immoral	a. 不道德的	improper
immoral	a. 不道德的	indecent
impermeable 	a. 不能渗透的	impervious
impermeable	a. 不能渗透的	impenetrable
impetus	n. 刺激;促进	incentive
impetus	v. 刺激;促进	stimulus
implausible	a. 难以置信的	unbelievable
implement	n. 工具	tool
implement	vt. 实施，执行	carry out
imply	v. 意味	indicate
imposing	a. 给人深刻印象的	impressive
imprecise	a. 不精确的	inexact
improbable	a. 不像会发生的	unlikely
in fact	phr. 事实上	actually
in great demand 	phr. 普遍	in popularity
in respect to	phr. 就…而言	in term of
inaccessible	a. 难接近的	unreachable
inadvertently 	ad. 非故意地	without knowing
inadvertently	ad. 非故意地	unintentionally
inaugurate 	vt.开创	introduce
inauspicious	a. 不吉利的	unfavorable
incentive	n.动机；刺激	motive
inception	n.起初	beginning
incidentally	ad. 顺便一提	by the way
inclement 	a. (气候)严酷的	unfavorable
inconceivable	a. 难以置信的	unimaginable
inconclusive	a. 不确定的	without result
incorporate	v. 包含	include
incorporate	v. 吸收;併入	merge
incursion	n. 入侵	invasion
indicate	v. 指示;指出	demonstrate
indigenous 	a. 本土的;土生土长的	native
indispensable 	a. 不可缺少的	essential
indispensable	a. 不可缺少的	necessary
indispensable	a. 不可缺少的	needed
indispensable	a. 不可缺少的	required
indispensable	a. 必不可少的	significant
indispensable	a. 不可缺少的	vital
indistinct	adj. 模糊的，不清楚的	not clear
induce 	v. 引起	bring
induce 	v. 引起	cause
inducement	n. 诱因，刺激物	incentive
ineffectively	ad. 无效地	without any result
inert	a. 迟缓的;惰性的	motionless
inert	a. 迟缓的;惰性的	motiveless
inevitable	a. 不可避免的	unavoidable
inference	n. 推断的结果	conclusion
infirm	a. 不坚定的;衰弱的	weak
inflate	v. 膨胀;扩大	expand
inflicting	v.使承受	bring about/ impose
infrastructure	n. 基础建设	foundation
ingenious	a. 心灵手巧的	very clever
ingenuity	n. 心灵手巧;独创性	cleverness
ingenuity	n. 心灵手巧;独创性	creativeness
ingenuity	n. 心灵手巧;独创性	inventiveness
ingenuity	n. 心灵手巧;独创性	resourcefulness
inherent	a. 内在的;固有的	essential
inherent	a. 与生俱来的	in characteristic of
inherent	a. 与生俱来的	instinctive
inherent	a. 内在的;固有的	internal
inherently 	ad. 固有地	essentially
inhibit 	v. 约束;抑制	hinder
inhospitable	a. 冷淡的;不适宜的	adverse
inhospitable	a. 冷淡的;不适宜的	unfavorable
initial	a. 最初的	first
initialing	v. 开始；创建	beginning
initially 	ad. 最初;开头	originally
initiate 	v. 开始;创始	start
initiate	v. 开始;创始	begin
innovation 	n. 革新;创新	new
innovative	a. 创新的	new
inordinate	a. 过度的	excessive
install	v. 放置，安置	put in place
instant	n. 片刻;瞬间	moment
instantaneous	a. 即刻的	immediate
instigate	v. 唆使;煽动	incite
instructive	v. 富有教育意义的	informative
insufficient	a. 不足的	inadequate
intact	a. 完好的	untouched
intact	adj. 完整的	complete
intangible 	a. 无形的	nonmaterial
intangible	a. 无形的	immaterial
integral	adj.不可或缺的	essential
integral	a. 构成整体所需要的	essential
intense 	a. 强烈的	strong
intentionally	ad. 有意地;故意地	deliberately
intercourse	n.交流	exchange
intermediate	a. 中间的;媒介	in between
intermingle	vt. 使混合；使搀和	interact
intimate 	a. 亲密的	close
intricate 	a. 复杂的	carefully shaped
intricate	a. 复杂的	complex
intrigue	v. 引发…兴趣	interest
intriguing	a. 迷人的	fascinating
intrinsic	a. 本质的;内在的	essential
intrinsic	a. 本质的;内在的	inherent
intrusive	a. 侵入的	invasive
invade	v. 入侵;侵犯	move into
invaluable	a. 极宝贵的	highly useful
invariably	ad. 始终如一地;一贯地	always
invent 	v. 发明	devise
inviolable 	a. 不可违背的	allowing no attack
inviolable	a. 不可违背的	without exception
invoke 	v. 垦求,祈求	appeal
irrecoverable 	a. 不能挽回的	permanent
irreparable	a. 不能挽回的	permanent
isolated	a. 孤立的;分离的	separated
jettison	v. 抛弃	release
jolt	v. 震动;震惊	shock
judge	v. 评判	estimate
junction 	n. 连接;接合	connection
juncture 	n. 连接;接合	connection
justified	a. 正当的	right
justify	v. 证明...是正当的	prove
key	a. 重要的;关键的	significant
lading	n. 货物	cargo
lading	n. 货物	shipment
landscape	n. 风景;景色	scenery
lap	n.落后	delay
large	a. 大的;大量的	extensive
largely 	ad. 大部分;主要地	mostly
launch	v. 发起;发动	initial
launch	v. 发起;发动	initiate
launch	v. 发起;发动	start
lax	adj. 马马虎虎的；不严谨的	careless
legitimacy	n. 合法性	authority
legitimately	ad. 正当地;合法地	properly
leisure	n. 闲暇	free time
leisurely	a. 悠闲的;从容不迫地	slowly
lethal 	a. 致命的	deadly
lethal	a. 致命的	fateful
liberal 	a. 宽大的	extensive
liken	v. 比较	to compare
likewise	ad. 同样地	similarly
linger	v. 徘徊;漫步	stroll
linger	v. 徘徊;漫步	wander
link	v. 连接	connect
link	v. 连接;结合	consist of
link	v. 连接;结合结合	put together
listening 	a. 留神听的	advertent
livelihood	n. 生活;生计	means of support
locale	n. 现场;场所	place
locate	v. 找出	find
lucrative	a. 有利益的	profitable
luxuriant	a. 茂盛的	thriving
magnify	v. 放大	enlarge
magnify	v.放大，加大	increase
magnitude 	n. 量;大小	amount
magnitude 	n. 巨大;广大	extent
maintain	v. 维持;使继续	continue
majestic	a. 壮观的	magnificent
make their way	phrv. 前进	travel
malleable 	a. 有延展性的;可塑的	pliable
mandatory 	a. 强制的;义务的	obligatory
mandatory 	a. 强制的;义务的	required
manifest	v. 表明;显现	reveal
manipulate	v. 操纵	control
marked 	a. 显着的	considerable
marked	adj.明显的，显著的	significant
markedly	ad. 显着地	distinctly
markedly	adv.显著地	noticeably
marvelously	adv.引人注目地	remarkably
mask 	v. 遮避;掩护;伪装	cover
mask	v. 遮避;掩护;伪装	disguise
massive	a. 巨大的	enormous
massive	a. 巨大的	huge
mastery	n. 控制	control
materialize	v. 产生，形成	come into being
matter	n. 问题;事件	issue
mature	adj. 成熟的	get older
maximum 	n. 最大量	greatest size
mean	n. 平均值	average
mechanism	n.机制，原理	means
merely 	ad. 仅仅	no more than
merely 	ad. 仅仅	only
merely	ad. 仅仅	simply
merge	v. 合併;融合	blend
merge	v. 合併;融合	combine
meticulously	ad. 小心地	carefully
microbe	n. 微生物;细菌	germ
milestone	n. 里程碑; 划时代的事件	significant event
milky way 	n. 银河	galaxy
mimic	v. 模仿	copy
mimic	v. 模仿	imitate
miniature	a. 微型的	small
minuscule	a. 微型的	tiny
minute 	a. 微小的	very small
minute	a. 微小的	tiny
minute	adj.少的	small
minutely	ad. 详细地;精密地	finely
minutely	ad. 详细地; 精密地	in detail
mirror	v. 反映;反射	reflect
misconception	n. 误解	wrong idea
misleading	a. 使人误解的	erroneous
misleading	a. 使人误解的	inaccurate
misleading	adj. 令人误解的	unreliable
misunderstanding	n. 误解	FALSE idea
misunderstanding	n. 误解	wrong idea
mock	v. 模仿	pretend
moderate	adj.温和的	temperate
modes	n.模式；方法	manner
modest 	a. 适度的	limited
modest	a. 适度的	not too large 
modification 	n. 修改;改变	alteration
modify	vt.修改，更改	change
momentous	a. 重要的	significant
monitor	v. 监控;监视	observe
monopolize	v. 独占；垄断	dominate
monotone	a. 单调的;乏味的	tedious
monotonous	a. 单调的;无聊的	boring
moreover 	ad. 此外	additionally
moreover	ad. 此外	in addition
motif	n. 图案	pattern
mount 	v. 增长	grow
mount	v. 登上	climb
mount	v. 增长	increase
mundane	a. 世俗的;平凡的	material
mundane	a. 世俗的;平凡的	ordinary
mutually exclusive	adj.矛盾的	contradictory
myriad	a. 大量的;无数的	countless
myriad	a. 大量的;无数的	innumerable
myriad	a. 大量的;无数的	numerous
narrow	v. 使变窄	limit
nature	n. 天性;本质	character
nearly	ad. 几乎;差不多	almost
necessary	a. 必要的	required
needless to say	phr. 不用说	obvious
nevertheless	ad. 然而;尽管	however
nevertheless	ad. 然而;尽管	in spite of
nocturnal 	a. 夜间的	nighttime
notable	a. 显着的;重要的	important
notable	a. 显着的;重要的	outstanding
notably	adv.明显地	especially
note 	v. 记录	record
noticeable	a. 显而易见的	obvious
notwithstanding	prep. 虽然; 尽管	despite
notwithstanding	conj. 虽然	nevertheless
objective	n. 目标	purpose
oblige	v. 强迫	force
obscure 	v. 使变暗;遮掩	conceal
obscure 	a. 模煳的	unclear
obscure	v. 使模煳	hide
obscure	a. 模煳的	not clear
obsession	n. 痴迷;迷恋	with fixation on
obtain	v. 取得;获得	acquire
obvious	a. 明显的	evident
occasion	n. 重大活动	event
occasionally	adv. 偶尔地	once in a while
of legitimacy	a. 合法的	lawful
of likelihood	a. 可能的	probable
offset	v. 补偿;抵销	balance
offset	v. 补偿;抵销	compensate
offset	v. 补偿;抵销抵销	make up
offset	vt.抵消	counterbalance
old male	n. 老人	aged male
omit 	v. 遗漏;删去	neglect
omit	v. 遗漏;删去	exclude
on the contrary	phr. 恰恰相反	on the other hand
on the contrary	phr. 恰恰相反	whereas
on the whole	ph. 大体上	in general
ongoing 	a. 进行的	current
onset 	n. 开始	start
onset	n. 开始	beginning
opaque 	a. 难理解的	impenetrable
optimal	a. 最佳的	most advantageous
optimal	adj. 最佳的；最理想的	ideal
option 	n. 选项;选择	choice
orchestrate	v. 精心安排	stage manage
orientation 	n. 观点	perspective
orientation	n. 介绍	introduction
originally	ad. 起初	at the first
originate from	v. 来源于	come into existence from
ornament	v. 装饰	decorate
ornamental 	a. 装饰的	decorative
ornamentation	n. 装饰	decoration
outbreak 	v. 爆发;突然发生	sudden increase
outcome	n. 结果	result
outermost	a. 最远的	farthermost away
overlook	vt. 忽略	ignore
overview	n. 概要	summary
overwhelming	a. 压倒性的	powerful
pace	n.速度	speed
pacify 	v. 使平静	assuage
paradox	n. 相反;矛盾	contrary
paradoxically	ad. 似非而是地	seemingly contradictory
parcel out 	phrv. 把...分成几份;分配	distribute
pare away	v. 修掉;削减削减	remove
partly 	ad. 部份地	in some degree
patch 	n. 小块土地	area
patch 	n. 斑点	spot
peak 	n. 高峰（期）	highest point
peak	n. 高峰（期）	maximum
peak	n. 高峰（期）	time of the greatest period
peak	n.顶点	summit/climax
peculiar	a. 奇怪的;独特的	strange
penetrate 	v. 穿入;穿透	enter
perceptible 	a. 可感知的	noticeable
perceptible	a. 可感知的	appreciable
peril	n. 危险	danger
perilous	a. 危险的	dangerous
perilous	a. 危险的	hazardous
perilous	a. 危险的	risky
perilous	a. 危险的	toxic
periodically	ad. 周期性地	from time to time
periodically	ad. 周期性地	regularly
perishable 	a. 易腐坏的	easy to spoil
permanent 	a. 永恒的	lasting
permeate 	v. 渗透;弥漫	penetrate
permit	v. 允许	allow
perpetual 	a. 永久的;连续的	constant
persist 	v. 坚持;持续	continue
persist	v. 坚持;持续	last
persistent	a. 耐久的	long lasting
personality	n. 个性;性格	character
pertinent 	a. 相关的	relevant
pervasive	a. 普遍的	widespread
phenomena 	n. 现象	events
phenomenal	a. 异常的	extraordinary
phenomenon	n. 现象	observable fact
phenomenon	n. 现象	occurrence
piecing 	n. 接合	joining
pigment	n. 色素	color
pigmentation	n. （生物的）天然颜色	coloring
pigmentation	n. 染色	dye
pinnacle 	n. 顶点;顶峰	high point
pinpoint 	v. 准确地解释或说明	clearly identify
pinpoint 	v. 准确地解释或说明	describe precisely
pinpoint 	a. 精确的	precise
plague	n.麻烦	cause problems
plausible 	a. 貌似有理的	believable
plausible 	a. 似是而非的	paradoxical
pledge	n. 保证;誓言	promise
plumage	n. 羽毛	feather
pocketbook	a. 负担得起的	affordable
popular	a. 流行的;广泛的	broad
popular	a. 流行的;广泛的	widespread
pore 	n. 毛孔;细孔	space
pore	n. 毛孔;细孔	hole
portable 	adj. 手提的，便携式的	can be carried
portion	n. 一部分	constituent
portion	n. 一部分	part
portions	n.部分	parts
pose 	v. 摆姿势;展现	present
pose	v. 摆姿势;展现	place
posit 	v. 断定;假定	assume
posit 	v. 断定;假定	propose
posit	v. 断定;假定	suggest
postulate	v. 假定	hypotheses
postulate	v. 假定	presume
potent 	a. 有力的	powerful
potential 	a. 潜在的;可能的	possible
potential	adj.可能的	capability
potential	adj.潜在的	latent
practically	ad. 几乎;差不多	nearly
pragmatic 	adj.实际的	practical
precarious 	a. 不稳定的;危险的	insecure
precede 	v. 高于;超出	be beyond
precede	v. 在…之前	come before
precious 	a. 宝贵的	valuable
precipitate 	v. 使…突然发生	bring about
precision 	n. 精确;正确	accuracy
preclude	v. 排除;阻止阻止	rule out
predicament 	n. 尴尬的处境;困境	difficult situation
predicament 	n. 尴尬的处境;困境	serious situation
prediction 	n. 预言	prophecy
predominant 	a. 占优势的	very noticeable
predominant	a. 占优势的	most aggressive
predominant	a. 占优势的	principal
predominantly	ad. 占优势地	primitively
predominately 	ad. 主要地	mainly
preeminent 	a. 卓越的;显着的	foremost
premise	v. 假定;前提	assume
premise	n. 假定;前提	assumption
premise	n.前提，假定	assumption
preoccupation with	phr. 专注于	concentration on
preordain 	v. 预定;注定	ordain
preordain	v. 预定;注定	appoint
preordain	v. 预定;註定	foreordain
prerequisite 	n. 必要条件	requirement
prerequisite	n.必要条件	something needed to happen
prerequisite	n. 必要条件	something required
preserve	v. 保存;保护	protect
preserve	v. 保存;保护	retain
preserve	v. 保存;保护	save
presumable	a. 可推测的;可能有的	probably
presumable	adj.可能有的，可推测的	supposable
prevailing	a. 占优势的	dominant
prevailing	a. 流行的	popular
prevalent 	a. 普遍的;流行的	common
prevalent 	a. 普遍的;流行的	prevailing
previous	a. 先前的;以往的	past
previously	ad. 以前;早先	before
primarily	ad. 主要地	mainly
primary	a. 主要的	dominant
primitive	a. 原始的	early
primitive	adj.简单的，粗糙的	basic and simple
principal 	a. 主要的	essential
principal	a. 主要的	major
principle	n. 原则	rule
principle	n. 原则	standard
prior 	a. 在先的;在前的	previous
priority	n. 优先	ranking preference
pristine	a. 清新的;纯朴的	pure
prized	a. 有价值的	valued
probe 	v. 探查;探测	explore
process	v. 加工	purify
procure 	v. 获得;取得	acquire
procure 	v. 获得;取得	obtain
profound	a. 深远的	far-reaching
profound	adj.深的	deep
programmed	a. 计画…的	determined
prohibitive	a. 抑止的	unaffordable
projection	n. 推测;估计	estimate
projection	n.预测，推断，设想	prediction
proliferating	vi.繁殖	multiplying
proliferation	n. 增产;增加	increase
prolifically	ad. 多产地	abundantly
prolong 	v. 延长	extend
prolong	adj.过长的	lengthy
prominent 	a. 显着的	eminent
prominent 	a. 卓越的;重要的	principal
prominent	a. 卓越的;重要的	outstanding
prominent	adj.突出的，重要的	important
promote	v. 促进;增长	encourage
promote	vt. 促进；提升；推销；发扬	enhance
prompt	n. 催促；激励；怂恿；提醒	cause
pronounced 	a. 明显的;显著的	definite
pronounced	a. 明显的;显著的	clear
pronounced	a. 明显的;显著的	notable
propagate	v. 繁殖	multiply
propagate	v. 繁殖	reproduce
propel 	v. 推进;激励	push
property 	n. 特性;属性	characteristic
property	n. 特性;属性	quality
proponent	n. 拥护者	supporter
proposal	n. 提议，建议	idea
prosper 	v. 成功;兴旺	succeed
prosperity	n. 幸福生活	well being
prosperous	a. 富有的;繁盛的	wealthy
prototype 	n. 原型	model
protrude 	v. 伸出;凸出	project
protrude 	v. 伸出;凸出凸出	stick out
protrude	v. 伸出;凸出	extend
provided	conj. 如果	if
provoke	v. 激起;导致	elicit
prowess 	n. 英勇	ambition
prowess	n. 非凡的技能	expertise
proximity 	n. 接近	nearness
proximity to	n. 邻近; 靠近	close to
proximity	n. 接近	closeness
pursue 	v. 追求;追赶	chase
quarters	n. 住处	residences
radical 	a. 彻底的;极端的	drastic
radical 	a. 彻底的;极端的	extreme
radical 	a. 根本的	fundamental
radically 	a. 根本地	completely
raise to	v. 引起; 使出现	cause to/ come about
ramification 	n. 结果;衍生物	consequence
ramification	n. 分枝;分派	branch
range	v. 变化;变动	vary
rare 	a. 稀有的;罕见的	scarce
rare	adj. 稀有的	unusual
rate	v. 评价;分等	classify
rather than	phr. 而不是	instead of
ravage	n.毁坏	destroy
readily 	ad. 容易地	easily
ready	a. 甘心的;情愿的	receptive
realm	n. 领域	area
rebellion	n. 反抗;叛乱	revolt
rebound	n. 重新振作	recovery
receptacle	n. 容器	receiver
receptivity to 	phr. 接受	openness to
recharge	v. 再充填	refill
recur	v. 反覆出现	repeat
refine	v. 精炼	improve
refined 	a. 精致的	decent
refined 	a. 精緻的	with high quality
refined	adj.精炼的	improved
refreshing	a. 别具一格的	unusual
refuge	n.庇护，庇护所	safety
refuse	n. 垃圾	garbage
regardless 	ad. 无论如何	without considering
regenerate	vt.新生，再生	renew
regrettable	adj.不幸的，令人遗憾的	unfortunate
regulate 	v. 调整;调节	adjust
regulate 	v. 管理;控制	control
reinforce	v. 加强	strengthen
relative	a. 比较的	comparative
relatively 	ad. 相对地;对比地	comparatively
relatively 	ad. 相对地;对比地	oppositely
relatively	ad. 相对地;对比地	correspondingly
relevant	adj. 有关的;恰当的	applicable
relic 	n. 遗物;遗迹	remain
relic	n. 遗物;遗迹	remnant
reluctance	n.不情愿，不愿意	unwillingness
reluctant	a. 不情愿的	disinclined
remarkable 	a. 非凡的;卓越的	notable
remarkable	a. 非凡的;卓越的	incredible
remarkably	adv. 显著地；非常地	surprisingly
remedy 	v. 治疗	cure
remnant 	a. 残留的	remaining
remnant	n. 残余	remains
remnant	n.剩余	left-over
remote	a. 遥远的	distant
remote	a. 遥远的	isolated
render	v. 使得	make
rendering	n. 演奏;表演	presentation
renowned	a. 有名的	famous
repercussion	n. 回响;影响	effect
replicas	n. 复制品	copies
repudiate	v. 否定;驳斥	reject
reputation	n. 名声	fame
resembling	vt.类似，近似	approximating
reserve 	v. 保存;保留	save
resident	n. 居民	inhabitant
residual 	a. 残留的	remaining
resilient 	a. 迅速恢复的	easy to recover
resilient	a. 迅速恢复的	quick to recover
respective	adj.每个的，各个的	particular
restricted	a. 受限制的	limited
resume 	vt.重新开始	start again
retain	v. 保持;保留	keep
retreat	v. 撤煺	recede
retrieve	v. 找回	bring back
reveal 	v. 展现;揭露	manifest
reveal 	v. 展现;揭露	show
reveal	v. 展现;揭露	make known
revenues	n. 税收	income
revival 	n. 恢复;再生	restoration
revival 	n. 恢复;再生	resuscitation
revive	v.重新，重演	recover
revolution	n. 彻底改革	dramatic change
revolutionize 	v. 彻底改革	change dramatically
rigidly	ad.严厉地	strictly
rigorous	a. 严厉的	demanding
rigorous	a. 严厉的	harsh
rigors	n.困难，严格	difficulties
rise	v. 出现	emerge
risk 	n. 危险	danger
ritual 	n. 仪式	ceremonial
rival 	v. 竞争;对抗	compete
roam	v. 漫游	wander
robust	a. 强壮的;结实的	healthy
role 	n. 作用	function
rotate	v. 转动	turn
roughly	ad. 大约地	approximately
roundabout	a. 迂回的	circuitous
route	n. 路径；途径	path
routinely	ad. 常规地	commonly
rudiment	n. 基础	basic
rudimentary 	a. 根本的	primitive
rudimentary	a. 根本的	basic
rupture	v. 破裂	burst
sacred	a. 神圣的	holy
sample	n. 样本;例子	example
satisfied 	a. 令人满意的	fulfilled
save for 	prep. 除…之外	except for
scale	n. 大小;等级	magnitude
scant	a. 少量的	minimal
scanty	adj. 缺乏的; 稀疏的	thin
scatter 	v. 使分散	distribute
scatter	v. 使分散	disperse
scented 	a. 有气味的	fragrant
scope 	n. 范围;程度	extent
scope 	n. 范围;程度	horizon
scorching	a. 酷热的	exceedingly hot
score 	n. 大量的;许多的	a large number of
scorn	v. 轻蔑;嘲笑	despise
scrap	n. 碎片	fragment
screen 	v. 过滤	filter
scrutinize	v. 详细审查	examine
scrutiny 	n. 详细审查	examination
sculpt	v. 雕刻;造型	shape
secrete	v. 分泌	produce
sedentary	a. 久坐的;固定的	settled
seek	vt.试图，企图	attempt
seething 	a. 激昂的	active
seething	a. 激昂的	excited
segment	n. 部分;片断	portion
seize	v. 抓住	take
seldom	a. 很少的	rare
sensational	adj. 轰动的	extraordinary
separate 	a. 各别的;不同的	different
serene	a. 平静的	calm
serene	a. 平静的	silent
set in	phrv. 开动	motion start
set off	phrv. 出发;动身;引起	begin
setback	n.挫折，失败	failure
settle 	v. 定居;安顿	inhabit
severe	a. 严厉的;严酷的	harsh
severity	n.严格，严肃	seriousness
shallow	a. 浅的	not deep
shatter	v. 打碎	destroy
sheer	a. 完全的	absolute
shield 	v. 保护	protect
shift 	v. 转换;转移	change
shift	v. 转换;转移	move
shiver	v. 发抖;打颤	tremor
showcase	v. 陈列	display
shrink	v. 缩水;收缩	contract
shy away from 	phrv. 回避；躲避	avoid
significance	n.重要性	importance
significant 	a. 重大的	considerable
significant 	a. 重大的	meaningful
significant	a. 重大的	important
simulated	a. 假装的;仿造的	artificial
simultaneously	ad. 同时地	at the same time
singularly 	ad. 非常;特别	particularly
sink	v. 下沉;下陷	descend
sink	v. 下沉;下陷	drop to the bottom
sink	v. 下沉;下陷	pass out of sight
site	v. 选址;设置	locate
size up	v. 估计	reckon up to
skeptical 	a. 怀疑的;多疑的	doubting
skeptical	a. 怀疑的;多疑的	suspected
skeptical	adj. 怀疑的	doubtful
slight	a. 轻微的;少量的	small
slightly	ad. 稍微地	somewhat
slope 	v. 倾斜	incline
snap	v. 断裂	break
so far	phr. 目前为止	until present
so far	phr. 目前为止	up to now
so far	phr. 目前为止	up to present
soak 	v. 吸收	absorb
sole	a. 单独的;唯一的	only
sole	a. 单独的;唯一的	unique
solicit	v. 垦求;请求	request
solitary	a. 单独的;独自的	alone
sophisticated 	a. 精致的;复杂的	complex
sophisticated 	a. 精致的;复杂的	refined
sophisticated	a. 精致的;复杂的	elaborated
sophistication	n. 工艺	technology
sort	n. 品种;种类	kind
sort	n. 品种;种类	type
source 	n. 来源	origin
span 	n. 一段时间	period
span	v.持续，延续	extend over
spark	v. 出发	set off
sparse 	a. 稀少的;零星的	not rich
spawn	v. 产卵;产生	create
spawn	v. 产卵;产生	produce
speak of 	phrv. 提及	indicate
speciation	n. 物种形成	evolution
specific	a. 特殊的;特定的	particular
specifically	adv. 特别地；明确地	specially
specify	v. 详细說明	state
spectacular	a. 引人入胜的	impressive
spectator	n. 目击者	beholder
spectator	n. 目击者	human viewer
spectator	n. 目击者	viewer
spectrum	n. 范围;系列	range
speed	v. 加速	increase the rate of
spell	n. 一段时间	period of time
sphere	n. 范围;领域	area
splendid	adj. 辉煌的；灿烂的	magnificent
splendor	n. 光彩;壮丽	magnificence
split	a. 裂开的；分离的	divided
sponsor 	vt. 赞助；发起	support
spontaneous 	a. 自发的;非计划安排的	impulsive
spontaneous	a. 自发的;非计划安排的	instinctive
spontaneous	a. 自发的;非计划安排的	unplanned
spontaneously	adv. 自发地；自然地；	automatically
sporadic	a. 偶尔发生的	intermittent
sporadic	a. 偶尔发生的	irregular
sporadically	ad. 偶尔	occasionally
spot	v. 看见;发现	catch
spot	v. 看见;发现	identify
spot	v. 看见;发现	see
spottily 	ad. 缺乏连续性	occasionally
spread	v. 散布	distribute
spur 	v. 刺激	stimulate
stabilize	v. 使稳定	hold in place
staggering	a. 巨大的	overwhelming
staple	a. 主要的	important
staunch 	a. 坚定的;可靠的	strong
staunch	a. 坚定的;可靠的	loyal
steadfast	a. 坚定的;固定的	firm
stealthily	ad. 悄悄地	silently
stem	v. 起源于	arise
stimulate	v. 刺激;促使	cause
stimulate	v. 刺激;促使	prompt
stockpile	v. 储备;贮存贮存	store up
strategy	n. 战略，策略	plan
strictly	ad. 仅仅	only
stride	n. 大步;阔步	step
strike	v. 撞击; 冲击	come into/ contract with
striking	a. 惊人的	dramatic
string	n. 一系列	series
stringent 	a. 严厉的	strict
strip 	v. 剥去	remove
stunning	adj.使人震惊的	astounding
sturdy 	a. 结实的;强壮的	strong
stylus	n. 钢笔	pen
subject to	a. 易受…影响的	vulnerable to
subjected to	v. 控制	dominated by
subsequent 	a. 后来的;随后的	later
subsequent	a. 后来的;随后的	ensuing
subsequent	a. 在…之后	following in time
subsidiary 	a. 次要的	less important
substantial 	a. 重大的;真实的	essential
substantial 	a. 坚固的	sturdy
substantial	a. 重大的;真实的	actual
substantial	a. 重大的;真实的	significant
substantial	adj.重大的，重要的	enough
substantially 	ad. 重大地	importantly
substantiate 	v. 证明;证实	confirm
substitute 	n. 代替物	replacement
substitute	v. 代替	replace
succession 	n. 一系列	series
successive	adj.连续的	continuous
successively	adv.相继的	one after another
sue	vt. 控告	raise a legal action against
suitable 	a. 合适的	appropriate
suited 	a. 合适的	appropriated
sumptuous	a. 奢侈的;豪华的	luxurious
sunk	a. 下陷的	down to the bottom
supplant	v. 代替;	replace
supplant	v. 代替;取代	substitute
supplemental	adj.额外的	additional
suppress 	v. 制止; 镇压	stop by force
surmise	v. 推测;猜测	assumption
surmise	v. 推测;猜测	guess
surmise	v. 推测	infer
surmise	v. 推测;猜测	infer
surplus 	a. 过剩的	extra
surplus	a. 过剩的	excess
surveillance	n. 监视;检查	careful observation
susceptible to 	a. 易受…影响的	prone to
suspect	v. 猜想;疑有	believe
suspect	v. 猜想;疑有	doubt
suspend 	v. 悬挂	hang
sustain 	v. 支撑;支持	support
sustain	v. 支持	persist
sustenance	n. 生计;食物	food
sustenance	n. 生计;食物	life
sustenance	n. 生计;食物	living
swell 	n. 增大;肿胀	enlargement
swell 	v. 增大;肿胀	expand
swiftly 	ad. 迅速地	quickly
symmetric	a. 对称的;均衡的	balance
synthesis	n. 合成	combination
tactual	a. 触觉的	textural
tailspin	n. 混乱; 失控	total confusion
take place	phrv. 发生	occur
take	v. 需要	require
tame	v. 驯服;驯化	domesticate
tangible 	a. 有形的;实际的	material
tangible 	a. 有形的;实际的	physical
tantalizing 	a. 非常着急的	anxious
taper	v. 逐渐变小	diminish
task	n. 任务	work
technique	n. 手段;方法	method
teem with	phrv. 充满;遍布	be full of
tempting	a. 吸引人的;诱人的	appealing
tenacity	n.固执	stability
tend	v. 趋于;照料	care for
tendency	n. 倾向	inclination
tenet	n. 原则;信条	belief
tenet	n. 原则;信条	principle
tension 	n. 紧张	pressure
tenuous 	a.脆弱的，无力的	weak
terminal	a. 末端的;终点的	final
terminal	adj.最终的	final
terrain	n. 地形;地势	tract
testify	v. 作证	give evidence
therefore 	ad. 因此	consequently
therefore	ad. 因此	in that purpose
thorough	adj. 彻底的；十分的；周密的	complete
thoroughly	ad. 完全地;彻底	completely
threaten	v. 危及	endanger
threshold 	n. 界限;起始点	limit
thrill	n.兴奋	excitement
through	prep. 通过	by
thus	ad. 因此	consequently
thus	adv.因此	therefore
tie 	n. 连接;关系	connection
tie	n. 连接;关系	relation
timid	a. 胆怯的	fearful
toil	v. 辛勤劳动	work
tolerate	v. 忍受	endure
toxic	a. 有毒的	poisonous
track 	v. 跟踪;追踪	follow
track 	v. 跟踪;追踪	observe
transfer	v. 转移;转变	move
transform	v. 转变	deform
transformation 	n. 转化;转换	shuffle
transformation	n. 转化;转换	change
transformation	n. 转化;转换	conversion
transformation	n. 转化;转换	rotation
transforming 	n. 转化;转换	changing
transitory 	a. 短暂的	short-lived
transitory	a. 短暂的	ephemeral
transitory	a. 短暂的	temporary
transitory	a. 短暂的	transient
trappings	n. 装饰	decorations
trauma	n. 损伤;精神创伤	damage
traverse	v. 横过;穿过	cross
tremendous 	adj.极大的，巨大的	enormous
trend	n. 趋势;走向	movement
trend	n. 趋势;走向	tendency
tricky	a. 狡猾的;棘手的	difficult
trigger	v. 触发;引发	initiate
trigger	v. 触发;引发	start
truism	n. 不言而喻的道理	it was evidence that
turbulent	a. 激动的	agitated
turn	v. 使变成	change to
typical	a. 平常的	ordinary
ubiquitous	a. 到处存在的	common
ultimate	adj. 最终的	in the end
ultimately 	ad. 最终	finally
ultimately	ad. 最终	eventually
unadorned	a. 未装饰的	not decorative
unanimity 	n. 一致同意	total agreement
undergo	v. 经历;经受	experience
underlying	a. 潜在的;隐含的	inner
underpinning	n. 基础;支柱;支撑	foundation
underpinning	n. 基础;支柱;支撑	support
underrate 	v. 低估;看轻	undervalue
underrate	v. 低估;看轻	underestimate
underscore 	v. 强调	stress
underscore	vt.强调	emphasize
undertake	v. 承担;担任	attempt
undertaking 	n. 事业;企业	enterprise
uneasy	a. 不稳定的	unstable
uniform	a. 统一的;一致的	without variation
uniformly 	ad. 一致地	consistently
uniformly	ad. 一致地	evenly
unintendedly 	ad. 非计画中	occasionally
unique to	a. 特有的	only found in
unique	a. 特有的	distinct
unique	a. 特有的	sole
universally 	ad. 在各种情况下	without exception
unleash	v. 释放	release
unprecedented 	a. 空前的	novel
unprecedented 	a. 空前的	unique
unprecedented	a. 空前的	initial
unprecedented	a. 空前的	new
unprecedented	adj.史无前例的	unexampled
unqualified 	a. 不合格的;无条件的	complete
unreceptive 	a. 接受能力差的	unresponsive
unresolved 	a. 未解决的	undecided
unrestricted 	a. 没有限制的	unlimited
unsophisticated 	a. 简单的	simple
unsuitable	a. 不适合的	inappropriate
unsurpassed 	a. 非常卓越的	superior
unwieldy	a. 笨重的	cumbersome
urbane 	a. 文雅的	cultivated
utilitarian	a. 实用的	functional
utilitarian	a. 实用的	practical
utterly	ad. 完全	completely
vagary	n. 难以预测的变化	uncertainty
vaguely	a. 模煳的	slightly
vanish	v. 消失	disappear
variability	n. 可变性;反覆不定	tendency to change
variation 	n. 变更;变化	difference
varied	a. 不相同的	different
vast 	a. 辽阔的	extended
vast	a. 辽阔的	extensive
vast	a. 巨大的	immense
vast	a. 大量的	large number
vast	adj.巨大的	huge
vastly	ad. 巨大地	greatly
vehicle 	n. 手段;工具	means
vehicle	n. 手段;工具	method
vehicle	n. 手段;工具	way
versatile	a. 多才多艺的	adaptable
versatile	adj.万能的综合的	all around
via	prep. 经过;凭藉	by means of
via	prep. 经过;凭藉	by the way of
vial	n. 小瓶	bottle
vibrant	a. 生气勃勃的	vivid
vigor	a. 生气勃勃的	energy
vigorous	a. 精力旺盛的	energetic
vigorous	a. 精力旺盛的	strong
virtually 	ad. 差不多	almost
virtually 	ad. 差不多	nearly
virtually	ad. 事实上地	actually
virtually	ad. 事实上地	in fact
visual barrier	phr. 视觉阻碍	obstacle to view
vital 	a. 极重要的	essential
vital	adj.必不可少的	essential
vivid	a. 鲜明的	bright
volume 	n. 数额	quantity
vulnerable 	a. 易受伤害的	open to attack
vulnerable	a. 易受伤害的	open to break
vulnerable	a. 易受伤害的	susceptible
vulnerable	a. 易受伤害的	weak
wanting	a. 不够好的	inadequate
warrant 	v. 授权	authorize
warrant 	v. 使正当	justify
wary	a. 小心的;谨慎的	cautious
way	n. （长途旅行的）小站	station stop
whatever	ad. 不管怎样	in any case
whereas	conj. 然而	however
whereby	conj. 凭藉;如何	through a process in which
while	conj. 虽然	although
whole	adj.整体的，全部的	entire
wholly 	ad. 完全地;全部	completely
wield	v. 行使	exert
within	ad. 在里面	inside
withstand	v. 承受;经受住	resist
withstand	v. 承受;经受住	tolerate
witness 	v. 目击	observe
yearly	a. 一年的	annual
yearning	a. 思念的;渴望的	longing
yet	conj. 然而	however
yield	v. 产生;提供	produce
yield	v. 产生;提供	provide
zenith	n. 顶点	peak
abandon	v.放弃	give up
accelerate	v.加速，提前	speed up
adequately	adv.足够地，充分地	sufficiently
adjacency	n.邻近	nearing
alleged	v.宣称	asserted
alleged	v.假定，断言	supposed
allocation	n.分布，分配	distribution
ancestor	n.祖先，前辈	forefather/progenitor
anonymous	adj.匿名的，无名的	nameless/incognito
arise	v.出现，发生	come about
back up 	n.支持，援助	support
concise	adj. 简明的，简要的	simple
confined to	v.仅限于	limited to
consistent	adj.始终如一的	uniform
controversy	n.冲突，争论	conflict/ disagreement
convey	v.传达，沟通	communicate
correspondingly	adv.相应地，对应地	accordingly
crisis	n.危机，混乱	disturbance
cuing	n.暗示	hint/clue
culminate	v.达到顶点	climax
culmination	n. 最高点	high point
designate	v. 指定，选派	assign
discipline	v.惩罚	punish
dispersed 	vi.分散	scatter
diversify	vt.使多样化	vary
divert	v.转向，转移	deflect
dramatically	adv.引人注目地	noticeably
edible	adj.可食用的	eatable
enormous	adj.巨大的	huge
epitomize	v.摘要，概括	exemplify
erroneous	adj.错误的，不正确的	wrong
faithful 	adj.忠诚的，忠实的	loyal
figuring out	v.计划	mapping
frigid	adj.寒冷的	cold
giant	adj.巨大的	huge
halt	vi.停止，终止	stop
immense	adj.巨大的	enormous
in tandem	adv.共同，一起	together
indiscriminately	adv.无差别的，随机的	at random
justly	adv.正当地，公证地	rightly
key	adj.关键的	critical
merit	n.价值	worth
modest 	adj.谦逊的	small
monopoly in	n.控制，垄断	domination
monumental	adj.作为纪念的，重要的	significant
notion	n.概念，想法	idea
now and then	adv.偶尔	occasionally
obviously 	adv.明显的	clearly
persistence 	n. 持续	continuing
plausible	adj. 看上去合理的	apparently reasonable and valid
preeminent	adj.优秀的，重要的	important
presumably	adv.大概	probably
prime	adj.主要的	main
radically	adv.根本地，完全地	extremely
rational	adj.合理的，理性的	sensible/logical
replenish	v.再储备，再装满	restore
scatter	v. 散播，传播	diffuse/disperse
scenario 	n.情形	situation
snaking	adj.蜿蜒的	winding
stagnation	n.停滞，不活动	inactivity
steady	adj. 稳定的，稳固的	stable
stipulate	v.规定	require
substantial	adj.大量的，客观的	large amount/considerable
subtle	adj.精细的	small
suspend	v.悬浮，漂浮	float
sustainable	adj.可持续的	endurable
tactic	n.战略，策略	strategy
tangible	adj.实在的，有形的	real/ concrete
threshold	n.界限	limitation
to be sure	adv.必定	certainly
traumatic	adj.外伤的，令人心烦意乱的	upsetting
virtue	n.优点	merit
